1111111111111
1P0100000Cg01
1000011111001
100P11E000001
1111111111111