1111111111
1P000000C1
111E000001
1111111111