111111
1E0001
100001
1C0001
1C0001
1C0001
1000P1
111111
