111111
1E0001
100001
100001
100001
100001
1P01C1
111111