111111
1E0001
100001
100001
1000C1
100000
1000P1
111111
