1111111111111111111111111111111111
1E0N00000C00000C00000C000000000001
1010010100100000101001000000010101
1010010010101010001001000000010101
1P00000N000000C0000000000N00000C01
1111111111111111111111111111111111