11111111111111111111111111111111111111111111111111111111111111111111111111111111111111111
1E0N00000C00000C00000C0000000000000N0000101000N0000101000N0000101000N0000101000N000010101
10100101001000001010010000000101000N0000101000N0000101000N0000101000N0000101000N000010101
10100100101010100010010000000101000N0000101000N0000101000N0000101000N0000101000N000010101
10100101001000001010010000000101000N0000101000N0000101000N0000101000N0000101000N000010101
10100100101010100010010000000101000N0000101000N0000101000N0000101000N0000101000N000010101
10100101001000001010010000000101000N0000101000N0000101000N0000101000N0000101000N000010101
10100100101010100010010000000101000N0000101000N0000101000N0000101000N0000101000N000010101
10100100101010100010010000000101000N0000101000N0000101000N0000101000N0000101000N000010101
10100101001000001010010000000101000N0000101000N0000101000N0000101000N0000101000N000010101
10100100101010100010010000000101000N0000101000N0000101000N0000101000N0000101000N000010101
1P00000N000000C0000000000N00000C000N0000101000N0000101000N0000101000N0000101000N000010101
11111111111111111111111111111111111111111111111111111111111111111111111111111111111111111