11111111111111111111111111111111111111111111111111111111111111111111111111111111111111111
1E0N00000C00N00C00000C0000000000000000001010000000010100000000101000000001010000000010101
10000101001000001010010000000101000000001010000000010100000000101000000001010000000010101
10000100101010100010010000000101000000001010000000010100000000101000000001010000000010101
10100101001000001010010000000101000000001010000000010100000000101000000001010000000010101
10100100101010100010010000000101000000001010000000010100000000101000000001010000000010101
10100101001000001010010000000101000000001010000000010100000000101000000001010000000010101
10100100101010100010010000000101000000001010000000010100000000101000000001010000000010101
10100100101010100010010000000101000000001010000000010100000000101000000001010000000010101
10100101001000001010010000000101000000001010000000010100000000101000000001010000000010101
10100100101010100010010000000101000000001010000000010100000000101000000001010000000010101
1P000000000000C0000000000N00000C00000000101000N000010100000000101000000001010000000010101
11111111111111111111111111111111111111111111111111111111111111111111111111111111111111111