1111111111111
1001000000N01
1000011111001
10P011E0000C1
1111111111111