1111111111111111111111111111111111
1E0000000C00000C000000000000000001
1000010100100000101001000N00010101
1010010010101010001001000000010101
1P000000000000C000000C000000000C01
1111111111111111111111111111111111